NO ./rsc/xpm/default_32x32_north.xpm
SO ./rsc/xpm/default_32x32_south.xpm
WE ./rsc/xpm/default_32x32_west.xpm
EA ./path_to_the_east_textur

F 220,100
C 225,30,0

111
1N01
1111
