NO ./sample_5184×3456.xpm
SO ./rsc/xpm/default_64x64_south.xpm
WE ./rsc/xpm/default_64x64_west.xpm
EA ./rsc/xpm/default_64x64_east.xpm
F 220,100,245
C 225,30,0

11111111111111111111111111111
10000000000000000000000000001
10000000000000000000000000001
10000000000000000000000000001
1000000000000000000000000001
1N000000000000000000000000001
10000000000000000000000000001
10000000000000000000000000001
10000000000000000000000000001
11111111111111111111111111111
