NO ./rsc/xpm/default_32x32_north.xpm
SO ./rsc/xpm/default_32x32_south.xpm
WE ./rsc/xpm/default_32x32_west.xpm
EA ./rsc/xpm/default_32x32_east.xpm
F 220,100,0
C 225,30,1

11111111111111111111111111111
10000000000000000000000000001
10000000000000000000000000001
10000000000000000000000000001
10NN0000000000000000000000001
10000000000000000000000000001
10000000000000000000000000001
10000000000000000000000000001
10000000000000000000000000001
11111111111111111111111111111
