NO ./path_to_north
SO ./rsc/xpm/default_32x32_south.xpm
WE ./rsc/xpm/default_32x32_west.xpm
EA ./rsc/xpm/default_32x32_east.xpm
F 220,100,24
C 225,30,0

11111111111111111111111111111
10000000000000000000000000001
10000000000000000000000000001
10000000000000000000000000001
10N0000000000000000000000001
10000000000000000000000000001
10000000000000000000000000001
10000000000000000000000000001
10000000000000000000000000001
11111111111111111111111111111
