NO ./rsc/xpm/default_32/north.xpm
SO ./rsc/xpm/default_32/south.xpm
WE ./rsc/xpm/default_32/west.xpm
EA ./rsc/xpm/default_32/east.xpm
C 0,255,255
F 50,255,50

11111111111111111111
10000100000000000001
11D01D10000000000001
10000000000000000001
10000000000000000001
10000000000000000001
10000000000000000001
10000000000000000001
10000000000000000001
10000000000000000001
10000000000000000001
1000000000N000000001
11111111111111111111
