NO ./rsc/xpm/wallN.xpm
SO ./rsc/xpm/wallS.xpm
WE ./rsc/xpm/wallW.xpm
EA ./rsc/xpm/wallE.xpm
C 0,255,255
F 50,255,50

111111111111
1000000001  1
1000000001   1
1000000001    1
1000000001    1
10S010100011111
100010000000001
100011100100001
100000101100001
100010100000001
111111111111111
