NO ./no_perm.xpm
SO ./rsc/xpm/default_32/south.xp
WE ./no_perm.xpm
EA ./rsc/xpm/default_32/east.xp

F a,256,-1
C 256,256,256

111
1N01
1111
