NO ./rsc/xpm/default_32x32_north.xp
SO ./rsc/xpm/default_32x32_south.xp
WE ./rsc/xpm/default_32x32_west.xp
EA ./path_to_the_east_textur

F 220,100,-1
C 225,30

111
1N01
1111
