NO ./rsc/xpm/default_32x32_north.xpm
SO ./rsc/xpm/default_32x32_south.xpm
WE ./rsc/xpm/default_32x32_west.xpm
EA ./rsc/xpm/default_32x32_east.xpm
F 220,100,24
C 225,30,0

111111111111
1000000001 1
10W010100011
100010000001
100011100101
100000101101
100010100001
111111111111
