NO ./rsc/xpm/realistic_1024/north.xpm
SO ./rsc/xpm/realistic_1024/south.xpm
WE ./rsc/xpm/realistic_1024/west.xpm
WE ./rsc/xpm/realistic_1024/east.xpm
EA ./rsc/xpm/realistic_1024/east.xpm
C 0,255,255
F 50,255,50

111111111111111
1000000001    1
1000000001    1
1000000001    1
1000000001    1
10S010100011111
100010000000001
100011100100001
1000001D1100001
100010100000001
111111111111111
