NO ./rsc/xpm/realistic_1024/north.xpm
SO ./rsc/xpm/realistic_1024/south.xpm
WE ./rsc/xpm/realistic_1024/west.xpm
EA ./rsc/xpm/realistic_1024/east.xpm
C 0,255,255
F 50,255,50

111111111111111
1000000001    1
1000000001    1
1000000001    1
1000000001    1
10S010101011111
10001000D000001
1000111D1100001
100000101100001
100010100000001
111111111111111
