NO ./rsc/xpm/default_64x64_north.xpm
SO ./rsc/xpm/default_64x64_south.xpm
WE ./rsc/xpm/default_64x64_west.xpm
EA ./rsc/xpm/default_64x64_east.xpm

F 220,100,0
C 225,30,0

11111111111111111111
10100000000001100001
10101000000001100001
10111000000000000001
10000000000000000001
10000000111000000001
10000001100000011111
10000000000000000N11
11111000000000011111
10000000000000000001
11111111111111111111
