NO ./rsc/xpm/default_64/north.xpm
SO ./rsc/xpm/default_64/south.xpm
WE ./rsc/xpm/default_64/west.xpm
EA ./rsc/xpm/default_64/east.xpm

F 240,120,20
C 200,220,255

11111111111111111111
10100000000001100001
10101000000001100001
10111000000000000001
10000000000000000001
10000000111000000001
10000001100000011111
10000000000000000W11
11111000000000011111
10000000000000000001
11111111111111111111
