NO ./rsc/xpm/realistic_1024/north.xpm
SO ./rsc/xpm/realistic_1024/south.xpm
WE ./rsc/xpm/realistic_1024/west.xpm
EA ./rsc/xpm/realistic_1024/east.xpm

C 0,255,255
F 50,255,50

11111111111111111111111111111111111111111111111111111111111111111111111111111111111111111111111111111111
10000000000000000000000000000000000000000000000000000000000000000000000000000000000000000000000000000001
10000000000000000000000000000000000000000000000000000000000000000000000000000000000000000000000000000001
10000000000000000000000000000000000000000000000000000000000000000000000000000000000000000000000000000001
10000000000000000010000000000000110000000000000000000000000001000000000000011000000000000000000000000001
10000000000000000000000000000000000000000000000000000000000000000000000000000000000000000000000000000001
10000000000000000000000000000000000000000000000000000000000000000000000000000000000000000000000000000001
10000000000000000000000000000000000000000000000000000000000000000000000000000000000000000000000000000001
10000000000000000000000000110000000000000001000000000000000000000000011000000000000000100000000000000001
10000000000000000000000000000000000000000000000000000000000000000000000000000000000000000000000000000001
10000000000000000000000000000000000000000000000000000000000000000000000000000000000000000000000000000001
10000000000000000000000000000000000000000000000000000000000000000000000000000000000000000000000000000001
1E000000000000000000000000000000110000000000000000000000000100000000000000010000000000000000000000000111
10000000000000000100000000000000000000000000001000000000000010000000000000000000000000000100000000000001
10000000000000000000000000000000000000000000000000000000000000000000000000000000000000000000000000000001
10000000000000000000001110000000000000000000000000000000000000000111000000000000000000000000000000000001
10000000000000000000000000000000000000000000000000000000000000000000000000000000000000000000000000000001
10000000000000000000000000000000000000000000000000000000000000000000000000000000000000000000000000000001
10000000000000000000000000000000000000110000000000000000000000000000000000000000011000000000000000000001
10000000000000000000000000000000000000000000000000000000000000000000000000000000000000000000000000000001
10000000000000000000000000000000000000000000000000000000000000000000000000000000000000000000000000000001
10000000000000000000000000000000000000000000000000000000000000000000000000000000000000000000000000000001
10000000000000000000000000000000000000000000000000000000000000000000000000000000000000000000000000000001
10000000000000000000000000000000000000000000000000000000000000000000000000000000000000000000000000000001
11111111111111111111111111111111111111111111111111111111111111111111111111111111111111111111111111111111

