NO ./rsc/xpm/default_64/north.xpm
SO ./rsc/xpm/default_64/south.xpm
WE ./rsc/xpm/default_64/west.xpm
EA ./rsc/xpm/default_64/east.xpm

F 220,100,0
C 225,30,0

111111111111
101000000001
101000000001
101000000001
100000000001
100000000001
100000010001
100000011001
10N000000001
100000000001
111111111111
