NO ./rsc/xpm/rat-spinning/64066bd33f9143c0f3c29144be11e55aQHExLe7VILhcURl5-11.xpm
NO ./rsc/xpm/rat-spinning/64066bd33f9143c0f3c29144be11e55aQHExLe7VILhcURl5-12.xpm
NO ./rsc/xpm/rat-spinning/64066bd33f9143c0f3c29144be11e55aQHExLe7VILhcURl5-13.xpm
NO ./rsc/xpm/rat-spinning/64066bd33f9143c0f3c29144be11e55aQHExLe7VILhcURl5-14.xpm
NO ./rsc/xpm/rat-spinning/64066bd33f9143c0f3c29144be11e55aQHExLe7VILhcURl5-15.xpm
NO ./rsc/xpm/rat-spinning/64066bd33f9143c0f3c29144be11e55aQHExLe7VILhcURl5-16.xpm
NO ./rsc/xpm/rat-spinning/64066bd33f9143c0f3c29144be11e55aQHExLe7VILhcURl5-17.xpm
NO ./rsc/xpm/rat-spinning/64066bd33f9143c0f3c29144be11e55aQHExLe7VILhcURl5-18.xpm
NO ./rsc/xpm/rat-spinning/64066bd33f9143c0f3c29144be11e55aQHExLe7VILhcURl5-19.xpm
NO ./rsc/xpm/rat-spinning/64066bd33f9143c0f3c29144be11e55aQHExLe7VILhcURl5-20.xpm
NO ./rsc/xpm/rat-spinning/64066bd33f9143c0f3c29144be11e55aQHExLe7VILhcURl5-21.xpm
NO ./rsc/xpm/rat-spinning/64066bd33f9143c0f3c29144be11e55aQHExLe7VILhcURl5-22.xpm
NO ./rsc/xpm/rat-spinning/64066bd33f9143c0f3c29144be11e55aQHExLe7VILhcURl5-23.xpm
NO ./rsc/xpm/rat-spinning/64066bd33f9143c0f3c29144be11e55aQHExLe7VILhcURl5-24.xpm
NO ./rsc/xpm/rat-spinning/64066bd33f9143c0f3c29144be11e55aQHExLe7VILhcURl5-25.xpm
NO ./rsc/xpm/rat-spinning/64066bd33f9143c0f3c29144be11e55aQHExLe7VILhcURl5-26.xpm
NO ./rsc/xpm/rat-spinning/64066bd33f9143c0f3c29144be11e55aQHExLe7VILhcURl5-27.xpm
NO ./rsc/xpm/rat-spinning/64066bd33f9143c0f3c29144be11e55aQHExLe7VILhcURl5-28.xpm
NO ./rsc/xpm/rat-spinning/64066bd33f9143c0f3c29144be11e55aQHExLe7VILhcURl5-29.xpm

NO ./rsc/xpm/rat-spinning/64066bd33f9143c0f3c29144be11e55aQHExLe7VILhcURl5-30.xpm
NO ./rsc/xpm/rat-spinning/64066bd33f9143c0f3c29144be11e55aQHExLe7VILhcURl5-31.xpm
NO ./rsc/xpm/rat-spinning/64066bd33f9143c0f3c29144be11e55aQHExLe7VILhcURl5-32.xpm
NO ./rsc/xpm/rat-spinning/64066bd33f9143c0f3c29144be11e55aQHExLe7VILhcURl5-33.xpm
NO ./rsc/xpm/rat-spinning/64066bd33f9143c0f3c29144be11e55aQHExLe7VILhcURl5-34.xpm
NO ./rsc/xpm/rat-spinning/64066bd33f9143c0f3c29144be11e55aQHExLe7VILhcURl5-35.xpm
NO ./rsc/xpm/rat-spinning/64066bd33f9143c0f3c29144be11e55aQHExLe7VILhcURl5-36.xpm
NO ./rsc/xpm/rat-spinning/64066bd33f9143c0f3c29144be11e55aQHExLe7VILhcURl5-37.xpm
NO ./rsc/xpm/rat-spinning/64066bd33f9143c0f3c29144be11e55aQHExLe7VILhcURl5-38.xpm
NO ./rsc/xpm/rat-spinning/64066bd33f9143c0f3c29144be11e55aQHExLe7VILhcURl5-39.xpm

NO ./rsc/xpm/rat-spinning/64066bd33f9143c0f3c29144be11e55aQHExLe7VILhcURl5-40.xpm
NO ./rsc/xpm/rat-spinning/64066bd33f9143c0f3c29144be11e55aQHExLe7VILhcURl5-41.xpm
NO ./rsc/xpm/rat-spinning/64066bd33f9143c0f3c29144be11e55aQHExLe7VILhcURl5-42.xpm
NO ./rsc/xpm/rat-spinning/64066bd33f9143c0f3c29144be11e55aQHExLe7VILhcURl5-43.xpm
NO ./rsc/xpm/rat-spinning/64066bd33f9143c0f3c29144be11e55aQHExLe7VILhcURl5-44.xpm
NO ./rsc/xpm/rat-spinning/64066bd33f9143c0f3c29144be11e55aQHExLe7VILhcURl5-45.xpm
NO ./rsc/xpm/rat-spinning/64066bd33f9143c0f3c29144be11e55aQHExLe7VILhcURl5-46.xpm
NO ./rsc/xpm/rat-spinning/64066bd33f9143c0f3c29144be11e55aQHExLe7VILhcURl5-47.xpm
NO ./rsc/xpm/rat-spinning/64066bd33f9143c0f3c29144be11e55aQHExLe7VILhcURl5-48.xpm
NO ./rsc/xpm/rat-spinning/64066bd33f9143c0f3c29144be11e55aQHExLe7VILhcURl5-49.xpm

NO ./rsc/xpm/rat-spinning/64066bd33f9143c0f3c29144be11e55aQHExLe7VILhcURl5-50.xpm
NO ./rsc/xpm/rat-spinning/64066bd33f9143c0f3c29144be11e55aQHExLe7VILhcURl5-51.xpm
NO ./rsc/xpm/rat-spinning/64066bd33f9143c0f3c29144be11e55aQHExLe7VILhcURl5-52.xpm
NO ./rsc/xpm/rat-spinning/64066bd33f9143c0f3c29144be11e55aQHExLe7VILhcURl5-53.xpm
NO ./rsc/xpm/rat-spinning/64066bd33f9143c0f3c29144be11e55aQHExLe7VILhcURl5-54.xpm
NO ./rsc/xpm/rat-spinning/64066bd33f9143c0f3c29144be11e55aQHExLe7VILhcURl5-55.xpm
NO ./rsc/xpm/rat-spinning/64066bd33f9143c0f3c29144be11e55aQHExLe7VILhcURl5-56.xpm
NO ./rsc/xpm/rat-spinning/64066bd33f9143c0f3c29144be11e55aQHExLe7VILhcURl5-57.xpm
NO ./rsc/xpm/rat-spinning/64066bd33f9143c0f3c29144be11e55aQHExLe7VILhcURl5-58.xpm
NO ./rsc/xpm/rat-spinning/64066bd33f9143c0f3c29144be11e55aQHExLe7VILhcURl5-59.xpm

NO ./rsc/xpm/rat-spinning/64066bd33f9143c0f3c29144be11e55aQHExLe7VILhcURl5-60.xpm
NO ./rsc/xpm/rat-spinning/64066bd33f9143c0f3c29144be11e55aQHExLe7VILhcURl5-61.xpm
NO ./rsc/xpm/rat-spinning/64066bd33f9143c0f3c29144be11e55aQHExLe7VILhcURl5-62.xpm
NO ./rsc/xpm/rat-spinning/64066bd33f9143c0f3c29144be11e55aQHExLe7VILhcURl5-63.xpm
NO ./rsc/xpm/rat-spinning/64066bd33f9143c0f3c29144be11e55aQHExLe7VILhcURl5-64.xpm
NO ./rsc/xpm/rat-spinning/64066bd33f9143c0f3c29144be11e55aQHExLe7VILhcURl5-65.xpm
NO ./rsc/xpm/rat-spinning/64066bd33f9143c0f3c29144be11e55aQHExLe7VILhcURl5-66.xpm
NO ./rsc/xpm/rat-spinning/64066bd33f9143c0f3c29144be11e55aQHExLe7VILhcURl5-67.xpm
NO ./rsc/xpm/rat-spinning/64066bd33f9143c0f3c29144be11e55aQHExLe7VILhcURl5-68.xpm
NO ./rsc/xpm/rat-spinning/64066bd33f9143c0f3c29144be11e55aQHExLe7VILhcURl5-69.xpm

NO ./rsc/xpm/rat-spinning/64066bd33f9143c0f3c29144be11e55aQHExLe7VILhcURl5-70.xpm
NO ./rsc/xpm/rat-spinning/64066bd33f9143c0f3c29144be11e55aQHExLe7VILhcURl5-71.xpm
NO ./rsc/xpm/rat-spinning/64066bd33f9143c0f3c29144be11e55aQHExLe7VILhcURl5-72.xpm
NO ./rsc/xpm/rat-spinning/64066bd33f9143c0f3c29144be11e55aQHExLe7VILhcURl5-73.xpm
NO ./rsc/xpm/rat-spinning/64066bd33f9143c0f3c29144be11e55aQHExLe7VILhcURl5-74.xpm
NO ./rsc/xpm/rat-spinning/64066bd33f9143c0f3c29144be11e55aQHExLe7VILhcURl5-75.xpm
NO ./rsc/xpm/rat-spinning/64066bd33f9143c0f3c29144be11e55aQHExLe7VILhcURl5-76.xpm
NO ./rsc/xpm/rat-spinning/64066bd33f9143c0f3c29144be11e55aQHExLe7VILhcURl5-77.xpm
NO ./rsc/xpm/rat-spinning/64066bd33f9143c0f3c29144be11e55aQHExLe7VILhcURl5-78.xpm
NO ./rsc/xpm/rat-spinning/64066bd33f9143c0f3c29144be11e55aQHExLe7VILhcURl5-79.xpm

NO ./rsc/xpm/rat-spinning/64066bd33f9143c0f3c29144be11e55aQHExLe7VILhcURl5-80.xpm
NO ./rsc/xpm/rat-spinning/64066bd33f9143c0f3c29144be11e55aQHExLe7VILhcURl5-81.xpm
NO ./rsc/xpm/rat-spinning/64066bd33f9143c0f3c29144be11e55aQHExLe7VILhcURl5-82.xpm
NO ./rsc/xpm/rat-spinning/64066bd33f9143c0f3c29144be11e55aQHExLe7VILhcURl5-83.xpm
NO ./rsc/xpm/rat-spinning/64066bd33f9143c0f3c29144be11e55aQHExLe7VILhcURl5-84.xpm
NO ./rsc/xpm/rat-spinning/64066bd33f9143c0f3c29144be11e55aQHExLe7VILhcURl5-85.xpm
NO ./rsc/xpm/rat-spinning/64066bd33f9143c0f3c29144be11e55aQHExLe7VILhcURl5-86.xpm
NO ./rsc/xpm/rat-spinning/64066bd33f9143c0f3c29144be11e55aQHExLe7VILhcURl5-87.xpm
NO ./rsc/xpm/rat-spinning/64066bd33f9143c0f3c29144be11e55aQHExLe7VILhcURl5-88.xpm

WE ./rsc/xpm/default_64/west.xpm
WE ./rsc/xpm/default_64/north.xpm
WE ./rsc/xpm/default_64/south.xpm
WE ./rsc/xpm/default_64/east.xpm
WE ./rsc/xpm/default_32/west.xpm
WE ./rsc/xpm/default_32/north.xpm
WE ./rsc/xpm/default_32/south.xpm
WE ./rsc/xpm/default_32/east.xpm
WE ./rsc/xpm/realistic_1024/north.xpm
WE ./rsc/xpm/realistic_1024/south.xpm
WE ./rsc/xpm/realistic_1024/west.xpm
WE ./rsc/xpm/realistic_1024/east.xpm
WE ./rsc/xpm/not_a_square.xpm
WE ./rsc/xpm/minimap/door_close_x16.xpm
WE ./rsc/xpm/minimap/door_open_x16.xpm
WE ./rsc/xpm/minimap/player_x2.xpm
WE ./rsc/xpm/minimap/player_x5.xpm
WE ./rsc/xpm/minimap/player_x8.xpm
WE ./rsc/xpm/minimap/void_x8.xpm
WE ./rsc/xpm/minimap/void_x16.xpm
WE ./rsc/xpm/minimap/void_x32.xpm
WE ./rsc/xpm/minimap/void_x64.xpm
WE ./rsc/xpm/minimap/wall_x8.xpm
WE ./rsc/xpm/minimap/wall_x16.xpm
WE ./rsc/xpm/minimap/wall_x32.xpm
WE ./rsc/xpm/minimap/wall_x64.xpm
WE ./rsc/xpm/flech/north.xpm
WE ./rsc/xpm/flech/south.xpm
WE ./rsc/xpm/flech/west.xpm
WE ./rsc/xpm/flech/east.xpm
WE ./rsc/xpm/flech/flech.xpm

SO ./rsc/xpm/maxwell-the-cat-maxwell/94b4ed84d1ad47a9b02c2c48f7a6e8eel8DylYN6doEjaKNe-0.xpm
SO ./rsc/xpm/maxwell-the-cat-maxwell/94b4ed84d1ad47a9b02c2c48f7a6e8eel8DylYN6doEjaKNe-1.xpm
SO ./rsc/xpm/maxwell-the-cat-maxwell/94b4ed84d1ad47a9b02c2c48f7a6e8eel8DylYN6doEjaKNe-2.xpm
SO ./rsc/xpm/maxwell-the-cat-maxwell/94b4ed84d1ad47a9b02c2c48f7a6e8eel8DylYN6doEjaKNe-3.xpm
SO ./rsc/xpm/maxwell-the-cat-maxwell/94b4ed84d1ad47a9b02c2c48f7a6e8eel8DylYN6doEjaKNe-4.xpm
SO ./rsc/xpm/maxwell-the-cat-maxwell/94b4ed84d1ad47a9b02c2c48f7a6e8eel8DylYN6doEjaKNe-5.xpm
SO ./rsc/xpm/maxwell-the-cat-maxwell/94b4ed84d1ad47a9b02c2c48f7a6e8eel8DylYN6doEjaKNe-6.xpm
SO ./rsc/xpm/maxwell-the-cat-maxwell/94b4ed84d1ad47a9b02c2c48f7a6e8eel8DylYN6doEjaKNe-7.xpm
SO ./rsc/xpm/maxwell-the-cat-maxwell/94b4ed84d1ad47a9b02c2c48f7a6e8eel8DylYN6doEjaKNe-8.xpm
SO ./rsc/xpm/maxwell-the-cat-maxwell/94b4ed84d1ad47a9b02c2c48f7a6e8eel8DylYN6doEjaKNe-9.xpm

SO ./rsc/xpm/maxwell-the-cat-maxwell/94b4ed84d1ad47a9b02c2c48f7a6e8eel8DylYN6doEjaKNe-10.xpm
SO ./rsc/xpm/maxwell-the-cat-maxwell/94b4ed84d1ad47a9b02c2c48f7a6e8eel8DylYN6doEjaKNe-11.xpm
SO ./rsc/xpm/maxwell-the-cat-maxwell/94b4ed84d1ad47a9b02c2c48f7a6e8eel8DylYN6doEjaKNe-12.xpm
SO ./rsc/xpm/maxwell-the-cat-maxwell/94b4ed84d1ad47a9b02c2c48f7a6e8eel8DylYN6doEjaKNe-13.xpm
SO ./rsc/xpm/maxwell-the-cat-maxwell/94b4ed84d1ad47a9b02c2c48f7a6e8eel8DylYN6doEjaKNe-14.xpm
SO ./rsc/xpm/maxwell-the-cat-maxwell/94b4ed84d1ad47a9b02c2c48f7a6e8eel8DylYN6doEjaKNe-15.xpm
SO ./rsc/xpm/maxwell-the-cat-maxwell/94b4ed84d1ad47a9b02c2c48f7a6e8eel8DylYN6doEjaKNe-16.xpm
SO ./rsc/xpm/maxwell-the-cat-maxwell/94b4ed84d1ad47a9b02c2c48f7a6e8eel8DylYN6doEjaKNe-17.xpm
SO ./rsc/xpm/maxwell-the-cat-maxwell/94b4ed84d1ad47a9b02c2c48f7a6e8eel8DylYN6doEjaKNe-18.xpm
SO ./rsc/xpm/maxwell-the-cat-maxwell/94b4ed84d1ad47a9b02c2c48f7a6e8eel8DylYN6doEjaKNe-19.xpm

SO ./rsc/xpm/maxwell-the-cat-maxwell/94b4ed84d1ad47a9b02c2c48f7a6e8eel8DylYN6doEjaKNe-20.xpm
SO ./rsc/xpm/maxwell-the-cat-maxwell/94b4ed84d1ad47a9b02c2c48f7a6e8eel8DylYN6doEjaKNe-21.xpm
SO ./rsc/xpm/maxwell-the-cat-maxwell/94b4ed84d1ad47a9b02c2c48f7a6e8eel8DylYN6doEjaKNe-22.xpm
SO ./rsc/xpm/maxwell-the-cat-maxwell/94b4ed84d1ad47a9b02c2c48f7a6e8eel8DylYN6doEjaKNe-23.xpm
SO ./rsc/xpm/maxwell-the-cat-maxwell/94b4ed84d1ad47a9b02c2c48f7a6e8eel8DylYN6doEjaKNe-24.xpm
SO ./rsc/xpm/maxwell-the-cat-maxwell/94b4ed84d1ad47a9b02c2c48f7a6e8eel8DylYN6doEjaKNe-25.xpm
SO ./rsc/xpm/maxwell-the-cat-maxwell/94b4ed84d1ad47a9b02c2c48f7a6e8eel8DylYN6doEjaKNe-26.xpm
SO ./rsc/xpm/maxwell-the-cat-maxwell/94b4ed84d1ad47a9b02c2c48f7a6e8eel8DylYN6doEjaKNe-27.xpm
SO ./rsc/xpm/maxwell-the-cat-maxwell/94b4ed84d1ad47a9b02c2c48f7a6e8eel8DylYN6doEjaKNe-28.xpm
SO ./rsc/xpm/maxwell-the-cat-maxwell/94b4ed84d1ad47a9b02c2c48f7a6e8eel8DylYN6doEjaKNe-29.xpm

SO ./rsc/xpm/maxwell-the-cat-maxwell/94b4ed84d1ad47a9b02c2c48f7a6e8eel8DylYN6doEjaKNe-30.xpm
SO ./rsc/xpm/maxwell-the-cat-maxwell/94b4ed84d1ad47a9b02c2c48f7a6e8eel8DylYN6doEjaKNe-31.xpm
SO ./rsc/xpm/maxwell-the-cat-maxwell/94b4ed84d1ad47a9b02c2c48f7a6e8eel8DylYN6doEjaKNe-32.xpm
SO ./rsc/xpm/maxwell-the-cat-maxwell/94b4ed84d1ad47a9b02c2c48f7a6e8eel8DylYN6doEjaKNe-33.xpm
SO ./rsc/xpm/maxwell-the-cat-maxwell/94b4ed84d1ad47a9b02c2c48f7a6e8eel8DylYN6doEjaKNe-34.xpm
SO ./rsc/xpm/maxwell-the-cat-maxwell/94b4ed84d1ad47a9b02c2c48f7a6e8eel8DylYN6doEjaKNe-35.xpm
SO ./rsc/xpm/maxwell-the-cat-maxwell/94b4ed84d1ad47a9b02c2c48f7a6e8eel8DylYN6doEjaKNe-36.xpm
SO ./rsc/xpm/maxwell-the-cat-maxwell/94b4ed84d1ad47a9b02c2c48f7a6e8eel8DylYN6doEjaKNe-37.xpm
SO ./rsc/xpm/maxwell-the-cat-maxwell/94b4ed84d1ad47a9b02c2c48f7a6e8eel8DylYN6doEjaKNe-38.xpm
SO ./rsc/xpm/maxwell-the-cat-maxwell/94b4ed84d1ad47a9b02c2c48f7a6e8eel8DylYN6doEjaKNe-39.xpm

SO ./rsc/xpm/maxwell-the-cat-maxwell/94b4ed84d1ad47a9b02c2c48f7a6e8eel8DylYN6doEjaKNe-40.xpm
SO ./rsc/xpm/maxwell-the-cat-maxwell/94b4ed84d1ad47a9b02c2c48f7a6e8eel8DylYN6doEjaKNe-41.xpm
SO ./rsc/xpm/maxwell-the-cat-maxwell/94b4ed84d1ad47a9b02c2c48f7a6e8eel8DylYN6doEjaKNe-42.xpm
SO ./rsc/xpm/maxwell-the-cat-maxwell/94b4ed84d1ad47a9b02c2c48f7a6e8eel8DylYN6doEjaKNe-43.xpm
SO ./rsc/xpm/maxwell-the-cat-maxwell/94b4ed84d1ad47a9b02c2c48f7a6e8eel8DylYN6doEjaKNe-44.xpm
SO ./rsc/xpm/maxwell-the-cat-maxwell/94b4ed84d1ad47a9b02c2c48f7a6e8eel8DylYN6doEjaKNe-45.xpm
SO ./rsc/xpm/maxwell-the-cat-maxwell/94b4ed84d1ad47a9b02c2c48f7a6e8eel8DylYN6doEjaKNe-46.xpm
SO ./rsc/xpm/maxwell-the-cat-maxwell/94b4ed84d1ad47a9b02c2c48f7a6e8eel8DylYN6doEjaKNe-47.xpm
SO ./rsc/xpm/maxwell-the-cat-maxwell/94b4ed84d1ad47a9b02c2c48f7a6e8eel8DylYN6doEjaKNe-48.xpm
SO ./rsc/xpm/maxwell-the-cat-maxwell/94b4ed84d1ad47a9b02c2c48f7a6e8eel8DylYN6doEjaKNe-49.xpm

SO ./rsc/xpm/maxwell-the-cat-maxwell/94b4ed84d1ad47a9b02c2c48f7a6e8eel8DylYN6doEjaKNe-50.xpm
SO ./rsc/xpm/maxwell-the-cat-maxwell/94b4ed84d1ad47a9b02c2c48f7a6e8eel8DylYN6doEjaKNe-51.xpm
SO ./rsc/xpm/maxwell-the-cat-maxwell/94b4ed84d1ad47a9b02c2c48f7a6e8eel8DylYN6doEjaKNe-52.xpm
SO ./rsc/xpm/maxwell-the-cat-maxwell/94b4ed84d1ad47a9b02c2c48f7a6e8eel8DylYN6doEjaKNe-53.xpm
SO ./rsc/xpm/maxwell-the-cat-maxwell/94b4ed84d1ad47a9b02c2c48f7a6e8eel8DylYN6doEjaKNe-54.xpm
SO ./rsc/xpm/maxwell-the-cat-maxwell/94b4ed84d1ad47a9b02c2c48f7a6e8eel8DylYN6doEjaKNe-55.xpm
SO ./rsc/xpm/maxwell-the-cat-maxwell/94b4ed84d1ad47a9b02c2c48f7a6e8eel8DylYN6doEjaKNe-56.xpm

EA ./rsc/xpm/maxwell-the-cat-maxwell/94b4ed84d1ad47a9b02c2c48f7a6e8eel8DylYN6doEjaKNe-56.xpm

F 0,255,0
C 0,0,255

   11111111111111
  1000000000001  1
 10000000000001   1
10000000N000001    1
100000000000001    1
10001011111100011111
10001000000000000001
10001111D11000100001
 1000010000101100001
  101010000100000001
   11111111 11111111
