NO ./rsc/xpm/rat-spinning/64066bd33f9143c0f3c29144be11e55aQHExLe7VILhcURl5-12.xpm
NO ./rsc/xpm/rat-spinning/64066bd33f9143c0f3c29144be11e55aQHExLe7VILhcURl5-13.xpm
NO ./rsc/xpm/rat-spinning/64066bd33f9143c0f3c29144be11e55aQHExLe7VILhcURl5-14.xpm
NO ./rsc/xpm/rat-spinning/64066bd33f9143c0f3c29144be11e55aQHExLe7VILhcURl5-15.xpm
NO ./rsc/xpm/rat-spinning/64066bd33f9143c0f3c29144be11e55aQHExLe7VILhcURl5-16.xpm
NO ./rsc/xpm/rat-spinning/64066bd33f9143c0f3c29144be11e55aQHExLe7VILhcURl5-17.xpm
NO ./rsc/xpm/rat-spinning/64066bd33f9143c0f3c29144be11e55aQHExLe7VILhcURl5-18.xpm
NO ./rsc/xpm/rat-spinning/64066bd33f9143c0f3c29144be11e55aQHExLe7VILhcURl5-19.xpm
NO ./rsc/xpm/rat-spinning/64066bd33f9143c0f3c29144be11e55aQHExLe7VILhcURl5-20.xpm
NO ./rsc/xpm/rat-spinning/64066bd33f9143c0f3c29144be11e55aQHExLe7VILhcURl5-21.xpm
NO ./rsc/xpm/rat-spinning/64066bd33f9143c0f3c29144be11e55aQHExLe7VILhcURl5-22.xpm
NO ./rsc/xpm/rat-spinning/64066bd33f9143c0f3c29144be11e55aQHExLe7VILhcURl5-23.xpm
NO ./rsc/xpm/rat-spinning/64066bd33f9143c0f3c29144be11e55aQHExLe7VILhcURl5-24.xpm
NO ./rsc/xpm/rat-spinning/64066bd33f9143c0f3c29144be11e55aQHExLe7VILhcURl5-25.xpm
NO ./rsc/xpm/rat-spinning/64066bd33f9143c0f3c29144be11e55aQHExLe7VILhcURl5-26.xpm
NO ./rsc/xpm/rat-spinning/64066bd33f9143c0f3c29144be11e55aQHExLe7VILhcURl5-27.xpm
NO ./rsc/xpm/rat-spinning/64066bd33f9143c0f3c29144be11e55aQHExLe7VILhcURl5-28.xpm
NO ./rsc/xpm/rat-spinning/64066bd33f9143c0f3c29144be11e55aQHExLe7VILhcURl5-29.xpm
NO ./rsc/xpm/rat-spinning/64066bd33f9143c0f3c29144be11e55aQHExLe7VILhcURl5-30.xpm
NO ./rsc/xpm/rat-spinning/64066bd33f9143c0f3c29144be11e55aQHExLe7VILhcURl5-31.xpm
NO ./rsc/xpm/rat-spinning/64066bd33f9143c0f3c29144be11e55aQHExLe7VILhcURl5-32.xpm
NO ./rsc/xpm/rat-spinning/64066bd33f9143c0f3c29144be11e55aQHExLe7VILhcURl5-33.xpm
NO ./rsc/xpm/rat-spinning/64066bd33f9143c0f3c29144be11e55aQHExLe7VILhcURl5-34.xpm
NO ./rsc/xpm/rat-spinning/64066bd33f9143c0f3c29144be11e55aQHExLe7VILhcURl5-35.xpm
NO ./rsc/xpm/rat-spinning/64066bd33f9143c0f3c29144be11e55aQHExLe7VILhcURl5-36.xpm
NO ./rsc/xpm/rat-spinning/64066bd33f9143c0f3c29144be11e55aQHExLe7VILhcURl5-37.xpm
NO ./rsc/xpm/rat-spinning/64066bd33f9143c0f3c29144be11e55aQHExLe7VILhcURl5-38.xpm
NO ./rsc/xpm/rat-spinning/64066bd33f9143c0f3c29144be11e55aQHExLe7VILhcURl5-39.xpm
NO ./rsc/xpm/rat-spinning/64066bd33f9143c0f3c29144be11e55aQHExLe7VILhcURl5-40.xpm
NO ./rsc/xpm/rat-spinning/64066bd33f9143c0f3c29144be11e55aQHExLe7VILhcURl5-41.xpm
NO ./rsc/xpm/rat-spinning/64066bd33f9143c0f3c29144be11e55aQHExLe7VILhcURl5-42.xpm
NO ./rsc/xpm/rat-spinning/64066bd33f9143c0f3c29144be11e55aQHExLe7VILhcURl5-43.xpm
NO ./rsc/xpm/rat-spinning/64066bd33f9143c0f3c29144be11e55aQHExLe7VILhcURl5-44.xpm
NO ./rsc/xpm/rat-spinning/64066bd33f9143c0f3c29144be11e55aQHExLe7VILhcURl5-45.xpm
NO ./rsc/xpm/rat-spinning/64066bd33f9143c0f3c29144be11e55aQHExLe7VILhcURl5-46.xpm
NO ./rsc/xpm/rat-spinning/64066bd33f9143c0f3c29144be11e55aQHExLe7VILhcURl5-47.xpm
NO ./rsc/xpm/rat-spinning/64066bd33f9143c0f3c29144be11e55aQHExLe7VILhcURl5-48.xpm
NO ./rsc/xpm/rat-spinning/64066bd33f9143c0f3c29144be11e55aQHExLe7VILhcURl5-49.xpm
NO ./rsc/xpm/rat-spinning/64066bd33f9143c0f3c29144be11e55aQHExLe7VILhcURl5-50.xpm
NO ./rsc/xpm/rat-spinning/64066bd33f9143c0f3c29144be11e55aQHExLe7VILhcURl5-51.xpm
NO ./rsc/xpm/rat-spinning/64066bd33f9143c0f3c29144be11e55aQHExLe7VILhcURl5-52.xpm
NO ./rsc/xpm/rat-spinning/64066bd33f9143c0f3c29144be11e55aQHExLe7VILhcURl5-53.xpm
NO ./rsc/xpm/rat-spinning/64066bd33f9143c0f3c29144be11e55aQHExLe7VILhcURl5-54.xpm
NO ./rsc/xpm/rat-spinning/64066bd33f9143c0f3c29144be11e55aQHExLe7VILhcURl5-55.xpm
NO ./rsc/xpm/rat-spinning/64066bd33f9143c0f3c29144be11e55aQHExLe7VILhcURl5-56.xpm
NO ./rsc/xpm/rat-spinning/64066bd33f9143c0f3c29144be11e55aQHExLe7VILhcURl5-57.xpm
NO ./rsc/xpm/rat-spinning/64066bd33f9143c0f3c29144be11e55aQHExLe7VILhcURl5-58.xpm
NO ./rsc/xpm/rat-spinning/64066bd33f9143c0f3c29144be11e55aQHExLe7VILhcURl5-59.xpm
NO ./rsc/xpm/rat-spinning/64066bd33f9143c0f3c29144be11e55aQHExLe7VILhcURl5-60.xpm
NO ./rsc/xpm/rat-spinning/64066bd33f9143c0f3c29144be11e55aQHExLe7VILhcURl5-61.xpm
NO ./rsc/xpm/rat-spinning/64066bd33f9143c0f3c29144be11e55aQHExLe7VILhcURl5-62.xpm
NO ./rsc/xpm/rat-spinning/64066bd33f9143c0f3c29144be11e55aQHExLe7VILhcURl5-63.xpm
NO ./rsc/xpm/rat-spinning/64066bd33f9143c0f3c29144be11e55aQHExLe7VILhcURl5-64.xpm
NO ./rsc/xpm/rat-spinning/64066bd33f9143c0f3c29144be11e55aQHExLe7VILhcURl5-65.xpm
NO ./rsc/xpm/rat-spinning/64066bd33f9143c0f3c29144be11e55aQHExLe7VILhcURl5-66.xpm
NO ./rsc/xpm/rat-spinning/64066bd33f9143c0f3c29144be11e55aQHExLe7VILhcURl5-67.xpm
NO ./rsc/xpm/rat-spinning/64066bd33f9143c0f3c29144be11e55aQHExLe7VILhcURl5-68.xpm
NO ./rsc/xpm/rat-spinning/64066bd33f9143c0f3c29144be11e55aQHExLe7VILhcURl5-69.xpm
NO ./rsc/xpm/rat-spinning/64066bd33f9143c0f3c29144be11e55aQHExLe7VILhcURl5-70.xpm
NO ./rsc/xpm/rat-spinning/64066bd33f9143c0f3c29144be11e55aQHExLe7VILhcURl5-71.xpm
NO ./rsc/xpm/rat-spinning/64066bd33f9143c0f3c29144be11e55aQHExLe7VILhcURl5-72.xpm
NO ./rsc/xpm/rat-spinning/64066bd33f9143c0f3c29144be11e55aQHExLe7VILhcURl5-73.xpm
NO ./rsc/xpm/rat-spinning/64066bd33f9143c0f3c29144be11e55aQHExLe7VILhcURl5-74.xpm
NO ./rsc/xpm/rat-spinning/64066bd33f9143c0f3c29144be11e55aQHExLe7VILhcURl5-75.xpm
NO ./rsc/xpm/rat-spinning/64066bd33f9143c0f3c29144be11e55aQHExLe7VILhcURl5-76.xpm
NO ./rsc/xpm/rat-spinning/64066bd33f9143c0f3c29144be11e55aQHExLe7VILhcURl5-77.xpm
NO ./rsc/xpm/rat-spinning/64066bd33f9143c0f3c29144be11e55aQHExLe7VILhcURl5-78.xpm
NO ./rsc/xpm/rat-spinning/64066bd33f9143c0f3c29144be11e55aQHExLe7VILhcURl5-79.xpm
NO ./rsc/xpm/rat-spinning/64066bd33f9143c0f3c29144be11e55aQHExLe7VILhcURl5-80.xpm
NO ./rsc/xpm/rat-spinning/64066bd33f9143c0f3c29144be11e55aQHExLe7VILhcURl5-81.xpm
NO ./rsc/xpm/rat-spinning/64066bd33f9143c0f3c29144be11e55aQHExLe7VILhcURl5-82.xpm
NO ./rsc/xpm/rat-spinning/64066bd33f9143c0f3c29144be11e55aQHExLe7VILhcURl5-83.xpm
NO ./rsc/xpm/rat-spinning/64066bd33f9143c0f3c29144be11e55aQHExLe7VILhcURl5-84.xpm
NO ./rsc/xpm/rat-spinning/64066bd33f9143c0f3c29144be11e55aQHExLe7VILhcURl5-85.xpm
NO ./rsc/xpm/rat-spinning/64066bd33f9143c0f3c29144be11e55aQHExLe7VILhcURl5-86.xpm
NO ./rsc/xpm/rat-spinning/64066bd33f9143c0f3c29144be11e55aQHExLe7VILhcURl5-87.xpm
NO ./rsc/xpm/rat-spinning/64066bd33f9143c0f3c29144be11e55aQHExLe7VILhcURl5-88.xpm


SO ./rsc/xpm/rat-spinning/64066bd33f9143c0f3c29144be11e55aQHExLe7VILhcURl5-0.xpm
SO ./rsc/xpm/rat-spinning/64066bd33f9143c0f3c29144be11e55aQHExLe7VILhcURl5-1.xpm
SO ./rsc/xpm/rat-spinning/64066bd33f9143c0f3c29144be11e55aQHExLe7VILhcURl5-2.xpm
SO ./rsc/xpm/rat-spinning/64066bd33f9143c0f3c29144be11e55aQHExLe7VILhcURl5-3.xpm
SO ./rsc/xpm/rat-spinning/64066bd33f9143c0f3c29144be11e55aQHExLe7VILhcURl5-4.xpm
SO ./rsc/xpm/rat-spinning/64066bd33f9143c0f3c29144be11e55aQHExLe7VILhcURl5-5.xpm
SO ./rsc/xpm/rat-spinning/64066bd33f9143c0f3c29144be11e55aQHExLe7VILhcURl5-6.xpm
SO ./rsc/xpm/rat-spinning/64066bd33f9143c0f3c29144be11e55aQHExLe7VILhcURl5-7.xpm
SO ./rsc/xpm/rat-spinning/64066bd33f9143c0f3c29144be11e55aQHExLe7VILhcURl5-8.xpm
SO ./rsc/xpm/rat-spinning/64066bd33f9143c0f3c29144be11e55aQHExLe7VILhcURl5-9.xpm
SO ./rsc/xpm/rat-spinning/64066bd33f9143c0f3c29144be11e55aQHExLe7VILhcURl5-10.xpm
SO ./rsc/xpm/rat-spinning/64066bd33f9143c0f3c29144be11e55aQHExLe7VILhcURl5-11.xpm
SO ./rsc/xpm/rat-spinning/64066bd33f9143c0f3c29144be11e55aQHExLe7VILhcURl5-12.xpm
SO ./rsc/xpm/rat-spinning/64066bd33f9143c0f3c29144be11e55aQHExLe7VILhcURl5-13.xpm
SO ./rsc/xpm/rat-spinning/64066bd33f9143c0f3c29144be11e55aQHExLe7VILhcURl5-14.xpm
SO ./rsc/xpm/rat-spinning/64066bd33f9143c0f3c29144be11e55aQHExLe7VILhcURl5-15.xpm
SO ./rsc/xpm/rat-spinning/64066bd33f9143c0f3c29144be11e55aQHExLe7VILhcURl5-16.xpm
SO ./rsc/xpm/rat-spinning/64066bd33f9143c0f3c29144be11e55aQHExLe7VILhcURl5-17.xpm
SO ./rsc/xpm/rat-spinning/64066bd33f9143c0f3c29144be11e55aQHExLe7VILhcURl5-18.xpm
SO ./rsc/xpm/rat-spinning/64066bd33f9143c0f3c29144be11e55aQHExLe7VILhcURl5-19.xpm
SO ./rsc/xpm/rat-spinning/64066bd33f9143c0f3c29144be11e55aQHExLe7VILhcURl5-20.xpm
SO ./rsc/xpm/rat-spinning/64066bd33f9143c0f3c29144be11e55aQHExLe7VILhcURl5-21.xpm
SO ./rsc/xpm/rat-spinning/64066bd33f9143c0f3c29144be11e55aQHExLe7VILhcURl5-22.xpm
SO ./rsc/xpm/rat-spinning/64066bd33f9143c0f3c29144be11e55aQHExLe7VILhcURl5-23.xpm
SO ./rsc/xpm/rat-spinning/64066bd33f9143c0f3c29144be11e55aQHExLe7VILhcURl5-24.xpm
SO ./rsc/xpm/rat-spinning/64066bd33f9143c0f3c29144be11e55aQHExLe7VILhcURl5-25.xpm
SO ./rsc/xpm/rat-spinning/64066bd33f9143c0f3c29144be11e55aQHExLe7VILhcURl5-26.xpm
SO ./rsc/xpm/rat-spinning/64066bd33f9143c0f3c29144be11e55aQHExLe7VILhcURl5-27.xpm
SO ./rsc/xpm/rat-spinning/64066bd33f9143c0f3c29144be11e55aQHExLe7VILhcURl5-28.xpm
SO ./rsc/xpm/rat-spinning/64066bd33f9143c0f3c29144be11e55aQHExLe7VILhcURl5-29.xpm
SO ./rsc/xpm/rat-spinning/64066bd33f9143c0f3c29144be11e55aQHExLe7VILhcURl5-30.xpm
SO ./rsc/xpm/rat-spinning/64066bd33f9143c0f3c29144be11e55aQHExLe7VILhcURl5-31.xpm
SO ./rsc/xpm/rat-spinning/64066bd33f9143c0f3c29144be11e55aQHExLe7VILhcURl5-32.xpm
SO ./rsc/xpm/rat-spinning/64066bd33f9143c0f3c29144be11e55aQHExLe7VILhcURl5-33.xpm
SO ./rsc/xpm/rat-spinning/64066bd33f9143c0f3c29144be11e55aQHExLe7VILhcURl5-34.xpm
SO ./rsc/xpm/rat-spinning/64066bd33f9143c0f3c29144be11e55aQHExLe7VILhcURl5-35.xpm
SO ./rsc/xpm/rat-spinning/64066bd33f9143c0f3c29144be11e55aQHExLe7VILhcURl5-36.xpm
SO ./rsc/xpm/rat-spinning/64066bd33f9143c0f3c29144be11e55aQHExLe7VILhcURl5-37.xpm
SO ./rsc/xpm/rat-spinning/64066bd33f9143c0f3c29144be11e55aQHExLe7VILhcURl5-38.xpm
SO ./rsc/xpm/rat-spinning/64066bd33f9143c0f3c29144be11e55aQHExLe7VILhcURl5-39.xpm
SO ./rsc/xpm/rat-spinning/64066bd33f9143c0f3c29144be11e55aQHExLe7VILhcURl5-40.xpm
SO ./rsc/xpm/rat-spinning/64066bd33f9143c0f3c29144be11e55aQHExLe7VILhcURl5-41.xpm
SO ./rsc/xpm/rat-spinning/64066bd33f9143c0f3c29144be11e55aQHExLe7VILhcURl5-42.xpm
SO ./rsc/xpm/rat-spinning/64066bd33f9143c0f3c29144be11e55aQHExLe7VILhcURl5-43.xpm
SO ./rsc/xpm/rat-spinning/64066bd33f9143c0f3c29144be11e55aQHExLe7VILhcURl5-44.xpm
SO ./rsc/xpm/rat-spinning/64066bd33f9143c0f3c29144be11e55aQHExLe7VILhcURl5-45.xpm
SO ./rsc/xpm/rat-spinning/64066bd33f9143c0f3c29144be11e55aQHExLe7VILhcURl5-46.xpm
SO ./rsc/xpm/rat-spinning/64066bd33f9143c0f3c29144be11e55aQHExLe7VILhcURl5-47.xpm
SO ./rsc/xpm/rat-spinning/64066bd33f9143c0f3c29144be11e55aQHExLe7VILhcURl5-48.xpm
SO ./rsc/xpm/rat-spinning/64066bd33f9143c0f3c29144be11e55aQHExLe7VILhcURl5-49.xpm
SO ./rsc/xpm/rat-spinning/64066bd33f9143c0f3c29144be11e55aQHExLe7VILhcURl5-50.xpm
SO ./rsc/xpm/rat-spinning/64066bd33f9143c0f3c29144be11e55aQHExLe7VILhcURl5-51.xpm
SO ./rsc/xpm/rat-spinning/64066bd33f9143c0f3c29144be11e55aQHExLe7VILhcURl5-52.xpm
SO ./rsc/xpm/rat-spinning/64066bd33f9143c0f3c29144be11e55aQHExLe7VILhcURl5-53.xpm
SO ./rsc/xpm/rat-spinning/64066bd33f9143c0f3c29144be11e55aQHExLe7VILhcURl5-54.xpm
SO ./rsc/xpm/rat-spinning/64066bd33f9143c0f3c29144be11e55aQHExLe7VILhcURl5-55.xpm
SO ./rsc/xpm/rat-spinning/64066bd33f9143c0f3c29144be11e55aQHExLe7VILhcURl5-56.xpm
SO ./rsc/xpm/rat-spinning/64066bd33f9143c0f3c29144be11e55aQHExLe7VILhcURl5-57.xpm
SO ./rsc/xpm/rat-spinning/64066bd33f9143c0f3c29144be11e55aQHExLe7VILhcURl5-58.xpm
SO ./rsc/xpm/rat-spinning/64066bd33f9143c0f3c29144be11e55aQHExLe7VILhcURl5-59.xpm
SO ./rsc/xpm/rat-spinning/64066bd33f9143c0f3c29144be11e55aQHExLe7VILhcURl5-60.xpm
SO ./rsc/xpm/rat-spinning/64066bd33f9143c0f3c29144be11e55aQHExLe7VILhcURl5-61.xpm
SO ./rsc/xpm/rat-spinning/64066bd33f9143c0f3c29144be11e55aQHExLe7VILhcURl5-62.xpm
SO ./rsc/xpm/rat-spinning/64066bd33f9143c0f3c29144be11e55aQHExLe7VILhcURl5-63.xpm
SO ./rsc/xpm/rat-spinning/64066bd33f9143c0f3c29144be11e55aQHExLe7VILhcURl5-64.xpm
SO ./rsc/xpm/rat-spinning/64066bd33f9143c0f3c29144be11e55aQHExLe7VILhcURl5-65.xpm
SO ./rsc/xpm/rat-spinning/64066bd33f9143c0f3c29144be11e55aQHExLe7VILhcURl5-66.xpm
SO ./rsc/xpm/rat-spinning/64066bd33f9143c0f3c29144be11e55aQHExLe7VILhcURl5-67.xpm
SO ./rsc/xpm/rat-spinning/64066bd33f9143c0f3c29144be11e55aQHExLe7VILhcURl5-68.xpm
SO ./rsc/xpm/rat-spinning/64066bd33f9143c0f3c29144be11e55aQHExLe7VILhcURl5-69.xpm
SO ./rsc/xpm/rat-spinning/64066bd33f9143c0f3c29144be11e55aQHExLe7VILhcURl5-70.xpm
SO ./rsc/xpm/rat-spinning/64066bd33f9143c0f3c29144be11e55aQHExLe7VILhcURl5-71.xpm
SO ./rsc/xpm/rat-spinning/64066bd33f9143c0f3c29144be11e55aQHExLe7VILhcURl5-72.xpm
SO ./rsc/xpm/rat-spinning/64066bd33f9143c0f3c29144be11e55aQHExLe7VILhcURl5-73.xpm
SO ./rsc/xpm/rat-spinning/64066bd33f9143c0f3c29144be11e55aQHExLe7VILhcURl5-74.xpm
SO ./rsc/xpm/rat-spinning/64066bd33f9143c0f3c29144be11e55aQHExLe7VILhcURl5-75.xpm
SO ./rsc/xpm/rat-spinning/64066bd33f9143c0f3c29144be11e55aQHExLe7VILhcURl5-76.xpm
SO ./rsc/xpm/rat-spinning/64066bd33f9143c0f3c29144be11e55aQHExLe7VILhcURl5-77.xpm
SO ./rsc/xpm/rat-spinning/64066bd33f9143c0f3c29144be11e55aQHExLe7VILhcURl5-78.xpm
SO ./rsc/xpm/rat-spinning/64066bd33f9143c0f3c29144be11e55aQHExLe7VILhcURl5-79.xpm
SO ./rsc/xpm/rat-spinning/64066bd33f9143c0f3c29144be11e55aQHExLe7VILhcURl5-80.xpm
SO ./rsc/xpm/rat-spinning/64066bd33f9143c0f3c29144be11e55aQHExLe7VILhcURl5-81.xpm
SO ./rsc/xpm/rat-spinning/64066bd33f9143c0f3c29144be11e55aQHExLe7VILhcURl5-82.xpm
SO ./rsc/xpm/rat-spinning/64066bd33f9143c0f3c29144be11e55aQHExLe7VILhcURl5-83.xpm
SO ./rsc/xpm/rat-spinning/64066bd33f9143c0f3c29144be11e55aQHExLe7VILhcURl5-84.xpm
SO ./rsc/xpm/rat-spinning/64066bd33f9143c0f3c29144be11e55aQHExLe7VILhcURl5-85.xpm
SO ./rsc/xpm/rat-spinning/64066bd33f9143c0f3c29144be11e55aQHExLe7VILhcURl5-86.xpm
SO ./rsc/xpm/rat-spinning/64066bd33f9143c0f3c29144be11e55aQHExLe7VILhcURl5-87.xpm
SO ./rsc/xpm/rat-spinning/64066bd33f9143c0f3c29144be11e55aQHExLe7VILhcURl5-88.xpm

WE ./rsc/xpm/rat-spinning/64066bd33f9143c0f3c29144be11e55aQHExLe7VILhcURl5-0.xpm
WE ./rsc/xpm/rat-spinning/64066bd33f9143c0f3c29144be11e55aQHExLe7VILhcURl5-1.xpm
WE ./rsc/xpm/rat-spinning/64066bd33f9143c0f3c29144be11e55aQHExLe7VILhcURl5-2.xpm
WE ./rsc/xpm/rat-spinning/64066bd33f9143c0f3c29144be11e55aQHExLe7VILhcURl5-3.xpm
WE ./rsc/xpm/rat-spinning/64066bd33f9143c0f3c29144be11e55aQHExLe7VILhcURl5-4.xpm
WE ./rsc/xpm/rat-spinning/64066bd33f9143c0f3c29144be11e55aQHExLe7VILhcURl5-5.xpm
WE ./rsc/xpm/rat-spinning/64066bd33f9143c0f3c29144be11e55aQHExLe7VILhcURl5-6.xpm
WE ./rsc/xpm/rat-spinning/64066bd33f9143c0f3c29144be11e55aQHExLe7VILhcURl5-7.xpm
WE ./rsc/xpm/rat-spinning/64066bd33f9143c0f3c29144be11e55aQHExLe7VILhcURl5-8.xpm
WE ./rsc/xpm/rat-spinning/64066bd33f9143c0f3c29144be11e55aQHExLe7VILhcURl5-9.xpm
WE ./rsc/xpm/rat-spinning/64066bd33f9143c0f3c29144be11e55aQHExLe7VILhcURl5-10.xpm
WE ./rsc/xpm/rat-spinning/64066bd33f9143c0f3c29144be11e55aQHExLe7VILhcURl5-11.xpm
WE ./rsc/xpm/rat-spinning/64066bd33f9143c0f3c29144be11e55aQHExLe7VILhcURl5-12.xpm
WE ./rsc/xpm/rat-spinning/64066bd33f9143c0f3c29144be11e55aQHExLe7VILhcURl5-13.xpm
WE ./rsc/xpm/rat-spinning/64066bd33f9143c0f3c29144be11e55aQHExLe7VILhcURl5-14.xpm
WE ./rsc/xpm/rat-spinning/64066bd33f9143c0f3c29144be11e55aQHExLe7VILhcURl5-15.xpm
WE ./rsc/xpm/rat-spinning/64066bd33f9143c0f3c29144be11e55aQHExLe7VILhcURl5-16.xpm
WE ./rsc/xpm/rat-spinning/64066bd33f9143c0f3c29144be11e55aQHExLe7VILhcURl5-17.xpm
WE ./rsc/xpm/rat-spinning/64066bd33f9143c0f3c29144be11e55aQHExLe7VILhcURl5-18.xpm
WE ./rsc/xpm/rat-spinning/64066bd33f9143c0f3c29144be11e55aQHExLe7VILhcURl5-19.xpm
WE ./rsc/xpm/rat-spinning/64066bd33f9143c0f3c29144be11e55aQHExLe7VILhcURl5-20.xpm
WE ./rsc/xpm/rat-spinning/64066bd33f9143c0f3c29144be11e55aQHExLe7VILhcURl5-21.xpm
WE ./rsc/xpm/rat-spinning/64066bd33f9143c0f3c29144be11e55aQHExLe7VILhcURl5-22.xpm
WE ./rsc/xpm/rat-spinning/64066bd33f9143c0f3c29144be11e55aQHExLe7VILhcURl5-23.xpm
WE ./rsc/xpm/rat-spinning/64066bd33f9143c0f3c29144be11e55aQHExLe7VILhcURl5-24.xpm
WE ./rsc/xpm/rat-spinning/64066bd33f9143c0f3c29144be11e55aQHExLe7VILhcURl5-25.xpm
WE ./rsc/xpm/rat-spinning/64066bd33f9143c0f3c29144be11e55aQHExLe7VILhcURl5-26.xpm
WE ./rsc/xpm/rat-spinning/64066bd33f9143c0f3c29144be11e55aQHExLe7VILhcURl5-27.xpm
WE ./rsc/xpm/rat-spinning/64066bd33f9143c0f3c29144be11e55aQHExLe7VILhcURl5-28.xpm
WE ./rsc/xpm/rat-spinning/64066bd33f9143c0f3c29144be11e55aQHExLe7VILhcURl5-29.xpm
WE ./rsc/xpm/rat-spinning/64066bd33f9143c0f3c29144be11e55aQHExLe7VILhcURl5-30.xpm
WE ./rsc/xpm/rat-spinning/64066bd33f9143c0f3c29144be11e55aQHExLe7VILhcURl5-31.xpm
WE ./rsc/xpm/rat-spinning/64066bd33f9143c0f3c29144be11e55aQHExLe7VILhcURl5-32.xpm
WE ./rsc/xpm/rat-spinning/64066bd33f9143c0f3c29144be11e55aQHExLe7VILhcURl5-33.xpm
WE ./rsc/xpm/rat-spinning/64066bd33f9143c0f3c29144be11e55aQHExLe7VILhcURl5-34.xpm
WE ./rsc/xpm/rat-spinning/64066bd33f9143c0f3c29144be11e55aQHExLe7VILhcURl5-35.xpm
WE ./rsc/xpm/rat-spinning/64066bd33f9143c0f3c29144be11e55aQHExLe7VILhcURl5-36.xpm
WE ./rsc/xpm/rat-spinning/64066bd33f9143c0f3c29144be11e55aQHExLe7VILhcURl5-37.xpm
WE ./rsc/xpm/rat-spinning/64066bd33f9143c0f3c29144be11e55aQHExLe7VILhcURl5-38.xpm
WE ./rsc/xpm/rat-spinning/64066bd33f9143c0f3c29144be11e55aQHExLe7VILhcURl5-39.xpm
WE ./rsc/xpm/rat-spinning/64066bd33f9143c0f3c29144be11e55aQHExLe7VILhcURl5-40.xpm
WE ./rsc/xpm/rat-spinning/64066bd33f9143c0f3c29144be11e55aQHExLe7VILhcURl5-41.xpm
WE ./rsc/xpm/rat-spinning/64066bd33f9143c0f3c29144be11e55aQHExLe7VILhcURl5-42.xpm
WE ./rsc/xpm/rat-spinning/64066bd33f9143c0f3c29144be11e55aQHExLe7VILhcURl5-43.xpm
WE ./rsc/xpm/rat-spinning/64066bd33f9143c0f3c29144be11e55aQHExLe7VILhcURl5-44.xpm
WE ./rsc/xpm/rat-spinning/64066bd33f9143c0f3c29144be11e55aQHExLe7VILhcURl5-45.xpm
WE ./rsc/xpm/rat-spinning/64066bd33f9143c0f3c29144be11e55aQHExLe7VILhcURl5-46.xpm
WE ./rsc/xpm/rat-spinning/64066bd33f9143c0f3c29144be11e55aQHExLe7VILhcURl5-47.xpm
WE ./rsc/xpm/rat-spinning/64066bd33f9143c0f3c29144be11e55aQHExLe7VILhcURl5-48.xpm
WE ./rsc/xpm/rat-spinning/64066bd33f9143c0f3c29144be11e55aQHExLe7VILhcURl5-49.xpm
WE ./rsc/xpm/rat-spinning/64066bd33f9143c0f3c29144be11e55aQHExLe7VILhcURl5-50.xpm
WE ./rsc/xpm/rat-spinning/64066bd33f9143c0f3c29144be11e55aQHExLe7VILhcURl5-51.xpm
WE ./rsc/xpm/rat-spinning/64066bd33f9143c0f3c29144be11e55aQHExLe7VILhcURl5-52.xpm
WE ./rsc/xpm/rat-spinning/64066bd33f9143c0f3c29144be11e55aQHExLe7VILhcURl5-53.xpm
WE ./rsc/xpm/rat-spinning/64066bd33f9143c0f3c29144be11e55aQHExLe7VILhcURl5-54.xpm
WE ./rsc/xpm/rat-spinning/64066bd33f9143c0f3c29144be11e55aQHExLe7VILhcURl5-55.xpm
WE ./rsc/xpm/rat-spinning/64066bd33f9143c0f3c29144be11e55aQHExLe7VILhcURl5-56.xpm
WE ./rsc/xpm/rat-spinning/64066bd33f9143c0f3c29144be11e55aQHExLe7VILhcURl5-57.xpm
WE ./rsc/xpm/rat-spinning/64066bd33f9143c0f3c29144be11e55aQHExLe7VILhcURl5-58.xpm
WE ./rsc/xpm/rat-spinning/64066bd33f9143c0f3c29144be11e55aQHExLe7VILhcURl5-59.xpm
WE ./rsc/xpm/rat-spinning/64066bd33f9143c0f3c29144be11e55aQHExLe7VILhcURl5-60.xpm
WE ./rsc/xpm/rat-spinning/64066bd33f9143c0f3c29144be11e55aQHExLe7VILhcURl5-61.xpm
WE ./rsc/xpm/rat-spinning/64066bd33f9143c0f3c29144be11e55aQHExLe7VILhcURl5-62.xpm
WE ./rsc/xpm/rat-spinning/64066bd33f9143c0f3c29144be11e55aQHExLe7VILhcURl5-63.xpm
WE ./rsc/xpm/rat-spinning/64066bd33f9143c0f3c29144be11e55aQHExLe7VILhcURl5-64.xpm
WE ./rsc/xpm/rat-spinning/64066bd33f9143c0f3c29144be11e55aQHExLe7VILhcURl5-65.xpm
WE ./rsc/xpm/rat-spinning/64066bd33f9143c0f3c29144be11e55aQHExLe7VILhcURl5-66.xpm
WE ./rsc/xpm/rat-spinning/64066bd33f9143c0f3c29144be11e55aQHExLe7VILhcURl5-67.xpm
WE ./rsc/xpm/rat-spinning/64066bd33f9143c0f3c29144be11e55aQHExLe7VILhcURl5-68.xpm
WE ./rsc/xpm/rat-spinning/64066bd33f9143c0f3c29144be11e55aQHExLe7VILhcURl5-69.xpm
WE ./rsc/xpm/rat-spinning/64066bd33f9143c0f3c29144be11e55aQHExLe7VILhcURl5-70.xpm
WE ./rsc/xpm/rat-spinning/64066bd33f9143c0f3c29144be11e55aQHExLe7VILhcURl5-71.xpm
WE ./rsc/xpm/rat-spinning/64066bd33f9143c0f3c29144be11e55aQHExLe7VILhcURl5-72.xpm
WE ./rsc/xpm/rat-spinning/64066bd33f9143c0f3c29144be11e55aQHExLe7VILhcURl5-73.xpm
WE ./rsc/xpm/rat-spinning/64066bd33f9143c0f3c29144be11e55aQHExLe7VILhcURl5-74.xpm
WE ./rsc/xpm/rat-spinning/64066bd33f9143c0f3c29144be11e55aQHExLe7VILhcURl5-75.xpm
WE ./rsc/xpm/rat-spinning/64066bd33f9143c0f3c29144be11e55aQHExLe7VILhcURl5-76.xpm
WE ./rsc/xpm/rat-spinning/64066bd33f9143c0f3c29144be11e55aQHExLe7VILhcURl5-77.xpm
WE ./rsc/xpm/rat-spinning/64066bd33f9143c0f3c29144be11e55aQHExLe7VILhcURl5-78.xpm
WE ./rsc/xpm/rat-spinning/64066bd33f9143c0f3c29144be11e55aQHExLe7VILhcURl5-79.xpm
WE ./rsc/xpm/rat-spinning/64066bd33f9143c0f3c29144be11e55aQHExLe7VILhcURl5-80.xpm
WE ./rsc/xpm/rat-spinning/64066bd33f9143c0f3c29144be11e55aQHExLe7VILhcURl5-81.xpm
WE ./rsc/xpm/rat-spinning/64066bd33f9143c0f3c29144be11e55aQHExLe7VILhcURl5-82.xpm
WE ./rsc/xpm/rat-spinning/64066bd33f9143c0f3c29144be11e55aQHExLe7VILhcURl5-83.xpm
WE ./rsc/xpm/rat-spinning/64066bd33f9143c0f3c29144be11e55aQHExLe7VILhcURl5-84.xpm
WE ./rsc/xpm/rat-spinning/64066bd33f9143c0f3c29144be11e55aQHExLe7VILhcURl5-85.xpm
WE ./rsc/xpm/rat-spinning/64066bd33f9143c0f3c29144be11e55aQHExLe7VILhcURl5-86.xpm
WE ./rsc/xpm/rat-spinning/64066bd33f9143c0f3c29144be11e55aQHExLe7VILhcURl5-87.xpm
WE ./rsc/xpm/rat-spinning/64066bd33f9143c0f3c29144be11e55aQHExLe7VILhcURl5-88.xpm

EA ./rsc/xpm/rat-spinning/64066bd33f9143c0f3c29144be11e55aQHExLe7VILhcURl5-0.xpm
EA ./rsc/xpm/rat-spinning/64066bd33f9143c0f3c29144be11e55aQHExLe7VILhcURl5-1.xpm
EA ./rsc/xpm/rat-spinning/64066bd33f9143c0f3c29144be11e55aQHExLe7VILhcURl5-2.xpm
EA ./rsc/xpm/rat-spinning/64066bd33f9143c0f3c29144be11e55aQHExLe7VILhcURl5-3.xpm
EA ./rsc/xpm/rat-spinning/64066bd33f9143c0f3c29144be11e55aQHExLe7VILhcURl5-4.xpm
EA ./rsc/xpm/rat-spinning/64066bd33f9143c0f3c29144be11e55aQHExLe7VILhcURl5-5.xpm
EA ./rsc/xpm/rat-spinning/64066bd33f9143c0f3c29144be11e55aQHExLe7VILhcURl5-6.xpm
EA ./rsc/xpm/rat-spinning/64066bd33f9143c0f3c29144be11e55aQHExLe7VILhcURl5-7.xpm
EA ./rsc/xpm/rat-spinning/64066bd33f9143c0f3c29144be11e55aQHExLe7VILhcURl5-8.xpm
EA ./rsc/xpm/rat-spinning/64066bd33f9143c0f3c29144be11e55aQHExLe7VILhcURl5-9.xpm
EA ./rsc/xpm/rat-spinning/64066bd33f9143c0f3c29144be11e55aQHExLe7VILhcURl5-10.xpm
EA ./rsc/xpm/rat-spinning/64066bd33f9143c0f3c29144be11e55aQHExLe7VILhcURl5-11.xpm
EA ./rsc/xpm/rat-spinning/64066bd33f9143c0f3c29144be11e55aQHExLe7VILhcURl5-12.xpm
EA ./rsc/xpm/rat-spinning/64066bd33f9143c0f3c29144be11e55aQHExLe7VILhcURl5-13.xpm
EA ./rsc/xpm/rat-spinning/64066bd33f9143c0f3c29144be11e55aQHExLe7VILhcURl5-14.xpm
EA ./rsc/xpm/rat-spinning/64066bd33f9143c0f3c29144be11e55aQHExLe7VILhcURl5-15.xpm
EA ./rsc/xpm/rat-spinning/64066bd33f9143c0f3c29144be11e55aQHExLe7VILhcURl5-16.xpm
EA ./rsc/xpm/rat-spinning/64066bd33f9143c0f3c29144be11e55aQHExLe7VILhcURl5-17.xpm
EA ./rsc/xpm/rat-spinning/64066bd33f9143c0f3c29144be11e55aQHExLe7VILhcURl5-18.xpm
EA ./rsc/xpm/rat-spinning/64066bd33f9143c0f3c29144be11e55aQHExLe7VILhcURl5-19.xpm
EA ./rsc/xpm/rat-spinning/64066bd33f9143c0f3c29144be11e55aQHExLe7VILhcURl5-20.xpm
EA ./rsc/xpm/rat-spinning/64066bd33f9143c0f3c29144be11e55aQHExLe7VILhcURl5-21.xpm
EA ./rsc/xpm/rat-spinning/64066bd33f9143c0f3c29144be11e55aQHExLe7VILhcURl5-22.xpm
EA ./rsc/xpm/rat-spinning/64066bd33f9143c0f3c29144be11e55aQHExLe7VILhcURl5-23.xpm
EA ./rsc/xpm/rat-spinning/64066bd33f9143c0f3c29144be11e55aQHExLe7VILhcURl5-24.xpm
EA ./rsc/xpm/rat-spinning/64066bd33f9143c0f3c29144be11e55aQHExLe7VILhcURl5-25.xpm
EA ./rsc/xpm/rat-spinning/64066bd33f9143c0f3c29144be11e55aQHExLe7VILhcURl5-26.xpm
EA ./rsc/xpm/rat-spinning/64066bd33f9143c0f3c29144be11e55aQHExLe7VILhcURl5-27.xpm
EA ./rsc/xpm/rat-spinning/64066bd33f9143c0f3c29144be11e55aQHExLe7VILhcURl5-28.xpm
EA ./rsc/xpm/rat-spinning/64066bd33f9143c0f3c29144be11e55aQHExLe7VILhcURl5-29.xpm
EA ./rsc/xpm/rat-spinning/64066bd33f9143c0f3c29144be11e55aQHExLe7VILhcURl5-30.xpm
EA ./rsc/xpm/rat-spinning/64066bd33f9143c0f3c29144be11e55aQHExLe7VILhcURl5-31.xpm
EA ./rsc/xpm/rat-spinning/64066bd33f9143c0f3c29144be11e55aQHExLe7VILhcURl5-32.xpm
EA ./rsc/xpm/rat-spinning/64066bd33f9143c0f3c29144be11e55aQHExLe7VILhcURl5-33.xpm
EA ./rsc/xpm/rat-spinning/64066bd33f9143c0f3c29144be11e55aQHExLe7VILhcURl5-34.xpm
EA ./rsc/xpm/rat-spinning/64066bd33f9143c0f3c29144be11e55aQHExLe7VILhcURl5-35.xpm
EA ./rsc/xpm/rat-spinning/64066bd33f9143c0f3c29144be11e55aQHExLe7VILhcURl5-36.xpm
EA ./rsc/xpm/rat-spinning/64066bd33f9143c0f3c29144be11e55aQHExLe7VILhcURl5-37.xpm
EA ./rsc/xpm/rat-spinning/64066bd33f9143c0f3c29144be11e55aQHExLe7VILhcURl5-38.xpm
EA ./rsc/xpm/rat-spinning/64066bd33f9143c0f3c29144be11e55aQHExLe7VILhcURl5-39.xpm
EA ./rsc/xpm/rat-spinning/64066bd33f9143c0f3c29144be11e55aQHExLe7VILhcURl5-40.xpm
EA ./rsc/xpm/rat-spinning/64066bd33f9143c0f3c29144be11e55aQHExLe7VILhcURl5-41.xpm
EA ./rsc/xpm/rat-spinning/64066bd33f9143c0f3c29144be11e55aQHExLe7VILhcURl5-42.xpm
EA ./rsc/xpm/rat-spinning/64066bd33f9143c0f3c29144be11e55aQHExLe7VILhcURl5-43.xpm
EA ./rsc/xpm/rat-spinning/64066bd33f9143c0f3c29144be11e55aQHExLe7VILhcURl5-44.xpm
EA ./rsc/xpm/rat-spinning/64066bd33f9143c0f3c29144be11e55aQHExLe7VILhcURl5-45.xpm
EA ./rsc/xpm/rat-spinning/64066bd33f9143c0f3c29144be11e55aQHExLe7VILhcURl5-46.xpm
EA ./rsc/xpm/rat-spinning/64066bd33f9143c0f3c29144be11e55aQHExLe7VILhcURl5-47.xpm
EA ./rsc/xpm/rat-spinning/64066bd33f9143c0f3c29144be11e55aQHExLe7VILhcURl5-48.xpm
EA ./rsc/xpm/rat-spinning/64066bd33f9143c0f3c29144be11e55aQHExLe7VILhcURl5-49.xpm
EA ./rsc/xpm/rat-spinning/64066bd33f9143c0f3c29144be11e55aQHExLe7VILhcURl5-50.xpm
EA ./rsc/xpm/rat-spinning/64066bd33f9143c0f3c29144be11e55aQHExLe7VILhcURl5-51.xpm
EA ./rsc/xpm/rat-spinning/64066bd33f9143c0f3c29144be11e55aQHExLe7VILhcURl5-52.xpm
EA ./rsc/xpm/rat-spinning/64066bd33f9143c0f3c29144be11e55aQHExLe7VILhcURl5-53.xpm
EA ./rsc/xpm/rat-spinning/64066bd33f9143c0f3c29144be11e55aQHExLe7VILhcURl5-54.xpm
EA ./rsc/xpm/rat-spinning/64066bd33f9143c0f3c29144be11e55aQHExLe7VILhcURl5-55.xpm
EA ./rsc/xpm/rat-spinning/64066bd33f9143c0f3c29144be11e55aQHExLe7VILhcURl5-56.xpm
EA ./rsc/xpm/rat-spinning/64066bd33f9143c0f3c29144be11e55aQHExLe7VILhcURl5-57.xpm
EA ./rsc/xpm/rat-spinning/64066bd33f9143c0f3c29144be11e55aQHExLe7VILhcURl5-58.xpm
EA ./rsc/xpm/rat-spinning/64066bd33f9143c0f3c29144be11e55aQHExLe7VILhcURl5-59.xpm
EA ./rsc/xpm/rat-spinning/64066bd33f9143c0f3c29144be11e55aQHExLe7VILhcURl5-60.xpm
EA ./rsc/xpm/rat-spinning/64066bd33f9143c0f3c29144be11e55aQHExLe7VILhcURl5-61.xpm
EA ./rsc/xpm/rat-spinning/64066bd33f9143c0f3c29144be11e55aQHExLe7VILhcURl5-62.xpm
EA ./rsc/xpm/rat-spinning/64066bd33f9143c0f3c29144be11e55aQHExLe7VILhcURl5-63.xpm
EA ./rsc/xpm/rat-spinning/64066bd33f9143c0f3c29144be11e55aQHExLe7VILhcURl5-64.xpm
EA ./rsc/xpm/rat-spinning/64066bd33f9143c0f3c29144be11e55aQHExLe7VILhcURl5-65.xpm
EA ./rsc/xpm/rat-spinning/64066bd33f9143c0f3c29144be11e55aQHExLe7VILhcURl5-66.xpm
EA ./rsc/xpm/rat-spinning/64066bd33f9143c0f3c29144be11e55aQHExLe7VILhcURl5-67.xpm
EA ./rsc/xpm/rat-spinning/64066bd33f9143c0f3c29144be11e55aQHExLe7VILhcURl5-68.xpm
EA ./rsc/xpm/rat-spinning/64066bd33f9143c0f3c29144be11e55aQHExLe7VILhcURl5-69.xpm
EA ./rsc/xpm/rat-spinning/64066bd33f9143c0f3c29144be11e55aQHExLe7VILhcURl5-70.xpm
EA ./rsc/xpm/rat-spinning/64066bd33f9143c0f3c29144be11e55aQHExLe7VILhcURl5-71.xpm
EA ./rsc/xpm/rat-spinning/64066bd33f9143c0f3c29144be11e55aQHExLe7VILhcURl5-72.xpm
EA ./rsc/xpm/rat-spinning/64066bd33f9143c0f3c29144be11e55aQHExLe7VILhcURl5-73.xpm
EA ./rsc/xpm/rat-spinning/64066bd33f9143c0f3c29144be11e55aQHExLe7VILhcURl5-74.xpm
EA ./rsc/xpm/rat-spinning/64066bd33f9143c0f3c29144be11e55aQHExLe7VILhcURl5-75.xpm
EA ./rsc/xpm/rat-spinning/64066bd33f9143c0f3c29144be11e55aQHExLe7VILhcURl5-76.xpm
EA ./rsc/xpm/rat-spinning/64066bd33f9143c0f3c29144be11e55aQHExLe7VILhcURl5-77.xpm
EA ./rsc/xpm/rat-spinning/64066bd33f9143c0f3c29144be11e55aQHExLe7VILhcURl5-78.xpm
EA ./rsc/xpm/rat-spinning/64066bd33f9143c0f3c29144be11e55aQHExLe7VILhcURl5-79.xpm
EA ./rsc/xpm/rat-spinning/64066bd33f9143c0f3c29144be11e55aQHExLe7VILhcURl5-80.xpm
EA ./rsc/xpm/rat-spinning/64066bd33f9143c0f3c29144be11e55aQHExLe7VILhcURl5-81.xpm
EA ./rsc/xpm/rat-spinning/64066bd33f9143c0f3c29144be11e55aQHExLe7VILhcURl5-82.xpm
EA ./rsc/xpm/rat-spinning/64066bd33f9143c0f3c29144be11e55aQHExLe7VILhcURl5-83.xpm
EA ./rsc/xpm/rat-spinning/64066bd33f9143c0f3c29144be11e55aQHExLe7VILhcURl5-84.xpm
EA ./rsc/xpm/rat-spinning/64066bd33f9143c0f3c29144be11e55aQHExLe7VILhcURl5-85.xpm
EA ./rsc/xpm/rat-spinning/64066bd33f9143c0f3c29144be11e55aQHExLe7VILhcURl5-86.xpm
EA ./rsc/xpm/rat-spinning/64066bd33f9143c0f3c29144be11e55aQHExLe7VILhcURl5-87.xpm
EA ./rsc/xpm/rat-spinning/64066bd33f9143c0f3c29144be11e55aQHExLe7VILhcURl5-88.xpm

F 220,100,0
C 225,30,0

   11111111111111
  1000000000001  1
 10000000000001   1
100000000000001    1
100000000000001    1
10001011111100011111
10001000000000000001
10001111D11000100001
 1000010000101100001
  10101N000100000001
   11111111 11111111
