F 0,100,0
NO                       ./path_to_the_north_texture
SO ./path_to_the_south_texture
WE ./path_to_the_west_texture
EA ./path_to_the_east_texture

C 225,0,0

111111
1001011
1010001
1100N11
11111
111111
111111
111111
111111
11111
111111
11111
